10 10
0 0 7 7
14  9  9  8  9  8  8  9  8 11
 6 15 12  3 12  3  6 13  0 11
 6 12  3 12  3 13  1  9  0 11
 4  3 12  3 12  9 10 12  0 11
 6 12  3 12  1  8  3  6  4 11
 4  3 12  3 15  6 14  6  4 11
 6 14  6 15 12  2  5  0  0 10
 6  6  4  9  1  1 11  7  6  7
 6  7  6 12  9  9  9 10  0 11
 5  9  1  1  9  9  9  1  3 15